! ! ! ! ! ! ! E ! ! ! ! ! ! ! ! ! ! ! ! ! !
! ! ! ! ! ! ! U U ! U U ! ! ! ! U ! ! ! ! !
! ! ! ! ! ! ! ! U U U U U U U U U U U ! ! !
! ! ! ! ! ! ! ! ! ! ! ! ! ! ! ! U ! ! ! ! !
! ! U U U U U ! U U U U U ! ! ! U ! ! ! ! !
! ! U ! ! U U U U ! ! ! U ! ! ! U ! ! ! ! !
! ! U ! ! ! U ! U ! ! ! U U U U U ! ! ! ! !
! ! U U U U U ! U U U U U ! ! U U ! ! ! ! !
! ! ! ! U ! ! ! ! ! ! ! ! ! ! U ! ! ! ! ! !
! ! ! ! O ! ! ! ! ! ! ! ! ! ! ! ! ! ! ! ! !