! ! ! ! ! ! ! ! ! ! ! ! ! ! ! ! ! ! ! ! ! ! ! ! ! ! ! ! !
! O U U U U ! ! ! ! ! U U U U U ! ! ! ! ! ! ! ! ! ! ! ! !
! U ! ! ! U U U U U U U ! U ! U U U U ! ! ! ! ! ! ! ! ! !
! U ! ! ! U ! ! ! ! ! U U U U U ! ! U ! ! ! ! ! ! ! ! ! !
! U U U U U ! ! ! ! ! ! ! ! U ! ! ! U ! ! ! ! ! ! ! ! ! !
! ! ! ! ! U ! ! ! ! ! ! ! ! U ! ! ! U ! ! ! ! ! ! ! ! ! !
! ! ! ! ! U U U U U U U U U U ! ! ! U ! ! ! ! ! ! ! ! ! !
! ! ! ! ! ! ! U ! ! ! ! ! ! ! ! ! ! U ! ! ! ! ! ! ! ! ! !
! ! ! ! U ! ! U ! ! ! ! ! ! ! ! ! ! U U U ! ! ! ! ! ! ! !
! U U U U U U U ! ! ! ! ! ! ! ! ! ! U U U ! ! ! ! ! ! ! !
! U ! U ! ! ! U ! U U U U ! ! ! ! ! U U U ! ! ! ! ! ! ! !
! U ! ! ! ! ! U ! U ! ! U U U U U U U ! U ! ! ! ! ! ! ! !
! ! ! ! ! ! ! U ! U ! ! U ! ! ! ! ! U U U U U U ! ! ! ! !
! ! ! ! ! ! ! U U U U U U ! ! ! ! ! ! ! ! ! ! U U ! ! ! !
! ! ! ! ! ! ! ! ! ! ! ! ! ! ! ! ! ! ! ! ! ! ! ! U U U U U
! ! ! ! ! ! ! ! ! ! ! ! ! ! ! ! ! ! ! ! ! ! ! ! ! ! ! ! !
! ! ! ! ! ! ! ! ! ! ! ! ! ! ! ! ! ! ! ! ! ! ! ! ! ! ! ! !
! ! ! ! ! ! ! ! ! ! ! ! ! ! ! ! ! ! ! ! ! ! ! ! ! ! ! ! !
