! ! ! ! ! ! ! ! ! !
! ! U ! U ! ! U ! !
! ! U ! ! ! ! U ! !
! U U U U U U U U !
! ! U ! U ! U ! U !
! ! U U U ! U ! U !
! O U ! ! ! U U U !
! ! ! ! ! ! ! ! ! !